{
  "id": "kohlenstadt",
  "name": "Kohlenstadt",
  "size": { "w": 28, "h": 28, "tile": 16 },
  "layers": {
    "ground": [
      [15,15,15,15,15,15,15,15,15,15,15,15,15,15,15,15,15,15,15,15,15,15,15,15,15,15,15,15],
      [15,15,15,15,15,15,15,15,15,15,15,15,15,15,15,15,15,15,15,15,15,15,15,15,15,15,15,15],
      [15,15,15,15,15,15,15,15,15,15,15,15,15,15,15,15,15,15,15,15,15,15,15,15,15,15,15,15],
      [15,15,15,15,15,15,15,15,15,15,15,15,15,15,15,15,15,15,15,15,15,15,15,15,15,15,15,15],
      [15,15,15,15,15,15,15,15,15,15,15,15,15,15,15,15,15,15,15,15,15,15,15,15,15,15,15,15],
      [15,15,15,12,15,15,15,15,15,15,15,15,15,15,15,15,15,15,15,15,15,15,19,19,19,19,19,15],
      [15,15,12,12,12,15,15,15,15,15,15,15,15,15,15,15,15,15,15,15,15,15,19,19,103,19,19,15],
      [15,12,12,12,12,12,15,15,15,15,15,15,15,15,15,15,15,15,19,19,19,19,19,19,19,19,19,15],
      [15,12,12,12,12,12,12,12,12,12,12,12,12,12,12,12,12,12,19,19,103,103,19,19,19,19,15,15],
      [15,12,12,12,12,12,12,12,12,12,12,12,12,12,12,12,12,12,19,19,19,19,19,15,15,15,15,15],
      [15,15,12,12,12,12,15,15,15,15,15,19,19,19,19,103,103,19,19,19,15,15,15,15,15,15,15,15],
      [15,15,15,12,12,15,15,15,15,15,15,19,19,19,19,19,19,19,19,19,15,15,15,15,15,15,15,15],
      [15,15,15,12,12,15,15,15,15,15,15,15,15,15,12,12,15,15,15,15,15,15,15,15,15,15,15,15],
      [15,15,15,12,12,15,15,15,15,15,15,15,15,12,12,12,12,15,15,15,15,15,15,15,15,15,15,15],
      [15,15,15,12,12,15,15,15,15,15,15,15,12,12,12,12,12,12,15,15,15,15,15,15,15,15,15,15],
      [15,19,19,19,19,19,19,15,15,15,15,12,12,12,12,12,12,12,12,15,15,19,19,19,19,19,15,15],
      [15,19,19,19,19,103,19,15,15,15,12,12,12,12,12,12,12,12,12,12,15,19,19,19,19,103,19,15],
      [15,19,19,19,19,19,19,15,15,15,12,12,12,12,12,12,12,12,12,12,15,19,19,19,19,19,19,15],
      [15,15,15,12,12,15,15,15,15,15,12,12,12,12,12,12,12,12,12,12,15,15,15,15,15,15,15,15],
      [15,15,15,12,12,15,15,15,15,15,15,12,12,12,12,12,12,12,12,15,15,15,15,15,15,15,15,15],
      [15,15,15,12,12,15,15,15,15,15,15,15,12,12,12,12,12,12,15,15,15,15,15,15,15,15,15,15],
      [15,15,15,12,12,15,15,15,15,15,15,15,15,12,12,12,12,15,15,15,15,15,15,15,15,15,15,15],
      [15,15,15,12,12,15,15,15,15,15,15,15,15,15,12,12,15,15,15,15,15,15,15,15,15,15,15,15],
      [15,15,15,12,12,15,15,15,15,15,15,15,15,15,12,12,15,15,15,15,15,15,15,15,15,15,15,15],
      [15,15,15,12,12,15,15,15,15,15,15,15,15,15,12,12,15,15,15,15,15,15,15,15,15,15,15,15],
      [15,15,15,12,12,15,15,15,15,15,15,15,15,15,12,12,15,15,15,15,15,15,15,15,15,15,15,15],
      [15,15,12,12,12,12,15,15,15,15,15,15,15,15,12,12,15,15,15,15,15,15,15,15,15,15,15,15],
      [15,12,12,12,12,12,12,12,12,12,12,12,12,12,12,12,12,12,12,12,12,12,12,12,12,12,12,15]
    ],
    "decor": [
      [27,27,27,27,27,27,27,27,27,27,27,27,27,27,27,27,27,27,27,27,27,27,27,27,27,27,27,27],
      [27,0,24,0,24,0,0,0,0,0,0,0,0,0,0,0,0,0,0,0,0,0,0,24,0,24,0,27],
      [27,24,0,0,0,24,0,0,0,0,0,0,0,0,0,0,0,0,0,0,0,0,24,0,0,0,24,27],
      [27,0,0,24,0,0,0,0,0,0,0,0,0,0,0,0,0,0,0,0,0,0,0,0,24,0,0,27],
      [27,0,24,0,24,0,0,0,0,0,0,0,0,0,0,0,0,0,0,0,0,0,0,24,0,24,0,27],
      [27,0,0,0,0,0,0,0,0,0,0,0,0,0,0,0,0,0,0,0,0,0,48,48,48,48,48,27],
      [27,0,0,0,0,0,0,0,0,0,0,0,0,0,0,0,0,0,0,0,0,0,48,52,52,52,48,27],
      [27,0,0,0,0,0,0,0,0,0,0,0,0,0,0,0,0,0,48,48,48,48,48,52,52,52,48,27],
      [27,0,0,0,0,0,0,0,0,0,0,0,0,0,0,0,0,0,48,52,52,52,48,48,48,48,0,27],
      [27,0,0,0,0,0,0,0,0,0,0,0,0,0,0,0,0,0,48,52,52,52,48,0,0,0,0,27],
      [27,0,0,0,0,0,0,0,0,0,0,48,48,48,48,48,48,48,48,48,0,0,0,0,0,0,0,27],
      [27,0,0,0,0,0,0,0,0,0,0,48,52,52,52,52,52,52,52,48,0,0,0,0,0,0,0,27],
      [27,0,0,0,0,0,0,0,0,0,0,0,0,0,0,0,0,0,0,0,0,0,0,0,0,0,0,27],
      [27,0,0,0,0,0,104,0,0,0,0,0,0,0,0,0,0,0,0,0,0,0,0,0,0,0,0,27],
      [27,0,0,0,0,0,0,0,0,0,0,0,0,0,0,0,0,0,0,0,0,0,0,0,0,0,0,27],
      [27,48,48,48,48,48,48,0,0,0,0,0,0,0,0,0,0,0,0,0,0,48,48,48,48,48,0,27],
      [27,48,52,52,52,52,48,0,104,0,0,0,0,0,0,0,0,0,0,0,0,48,52,52,52,52,48,27],
      [27,48,48,48,48,48,48,0,0,0,0,0,0,0,0,0,0,0,0,0,0,48,48,48,48,48,48,27],
      [27,0,0,0,0,0,0,0,0,0,0,0,0,0,0,0,0,0,0,0,0,0,0,0,0,0,0,27],
      [27,0,0,0,0,0,0,0,0,0,0,0,0,0,0,0,0,0,0,0,0,0,0,0,0,0,0,27],
      [27,0,0,0,0,0,0,0,0,0,0,0,0,0,0,0,0,0,0,0,0,0,0,0,0,0,0,27],
      [27,0,0,0,0,0,0,0,0,0,0,0,0,0,0,0,0,0,0,0,0,0,0,0,0,0,0,27],
      [27,0,0,0,0,0,0,0,0,0,0,0,0,0,0,0,0,0,0,0,0,0,0,0,0,0,0,27],
      [27,0,0,0,0,0,0,0,0,0,0,0,0,0,0,0,0,0,0,27,0,0,0,0,0,0,0,27],
      [27,0,0,0,0,0,0,0,0,0,0,0,0,0,0,0,0,0,27,27,27,0,0,0,0,0,0,27],
      [27,0,0,0,0,0,0,0,0,0,0,0,0,0,0,0,0,27,27,27,27,27,0,0,0,0,0,27],
      [27,0,0,0,0,0,104,0,0,0,0,0,0,0,0,0,0,0,27,27,27,0,0,0,0,0,0,27],
      [27,0,0,0,0,0,0,0,0,0,0,0,0,0,0,0,0,0,0,0,0,0,0,0,0,0,0,27]
    ],
    "collision": [
      [1,1,1,1,1,1,1,1,1,1,1,1,1,1,1,1,1,1,1,1,1,1,1,1,1,1,1,1],
      [1,0,1,0,1,0,0,0,0,0,0,0,0,0,0,0,0,0,0,0,0,0,0,1,0,1,0,1],
      [1,1,0,0,0,1,0,0,0,0,0,0,0,0,0,0,0,0,0,0,0,0,1,0,0,0,1,1],
      [1,0,0,1,0,0,0,0,0,0,0,0,0,0,0,0,0,0,0,0,0,0,0,0,1,0,0,1],
      [1,0,1,0,1,0,0,0,0,0,0,0,0,0,0,0,0,0,0,0,0,0,0,1,0,1,0,1],
      [1,0,0,0,0,0,0,0,0,0,0,0,0,0,0,0,0,0,0,0,0,0,1,1,1,1,1,1],
      [1,0,0,0,0,0,0,0,0,0,0,0,0,0,0,0,0,0,0,0,0,0,1,1,0,1,1,1],
      [1,0,0,0,0,0,0,0,0,0,0,0,0,0,0,0,0,0,1,1,1,1,1,1,1,1,1,1],
      [1,0,0,0,0,0,0,0,0,0,0,0,0,0,0,0,0,0,1,1,0,0,1,1,1,1,0,1],
      [1,0,0,0,0,0,0,0,0,0,0,0,0,0,0,0,0,0,1,1,1,1,1,0,0,0,0,1],
      [1,0,0,0,0,0,0,0,0,0,0,1,1,1,1,0,0,1,1,1,0,0,0,0,0,0,0,1],
      [1,0,0,0,0,0,0,0,0,0,0,1,1,1,1,1,1,1,1,1,0,0,0,0,0,0,0,1],
      [1,0,0,0,0,0,0,0,0,0,0,0,0,0,0,0,0,0,0,0,0,0,0,0,0,0,0,1],
      [1,0,0,0,0,0,1,0,0,0,0,0,0,0,0,0,0,0,0,0,0,0,0,0,0,0,0,1],
      [1,0,0,0,0,0,0,0,0,0,0,0,0,0,0,0,0,0,0,0,0,0,0,0,0,0,0,1],
      [1,1,1,1,1,1,1,0,0,0,0,0,0,0,0,0,0,0,0,0,0,1,1,1,1,1,0,1],
      [1,1,1,1,1,0,1,0,1,0,0,0,0,0,0,0,0,0,0,0,0,1,1,1,1,0,1,1],
      [1,1,1,1,1,1,1,0,0,0,0,0,0,0,0,0,0,0,0,0,0,1,1,1,1,1,1,1],
      [1,0,0,0,0,0,0,0,0,0,0,0,0,0,0,0,0,0,0,0,0,0,0,0,0,0,0,1],
      [1,0,0,0,0,0,0,0,0,0,0,0,0,0,0,0,0,0,0,0,0,0,0,0,0,0,0,1],
      [1,0,0,0,0,0,0,0,0,0,0,0,0,0,0,0,0,0,0,0,0,0,0,0,0,0,0,1],
      [1,0,0,0,0,0,0,0,0,0,0,0,0,0,0,0,0,0,0,0,0,0,0,0,0,0,0,1],
      [1,0,0,0,0,0,0,0,0,0,0,0,0,0,0,0,0,0,0,0,0,0,0,0,0,0,0,1],
      [1,0,0,0,0,0,0,0,0,0,0,0,0,0,0,0,0,0,0,1,0,0,0,0,0,0,0,1],
      [1,0,0,0,0,0,0,0,0,0,0,0,0,0,0,0,0,0,1,1,1,0,0,0,0,0,0,1],
      [1,0,0,0,0,0,0,0,0,0,0,0,0,0,0,0,0,1,1,1,1,1,0,0,0,0,0,1],
      [1,0,0,0,0,0,1,0,0,0,0,0,0,0,0,0,0,0,1,1,1,0,0,0,0,0,0,1],
      [1,0,0,0,0,0,0,0,0,0,0,0,0,0,0,0,0,0,0,0,0,0,0,0,0,0,0,1]
    ],
    "overhang": [
      [0,0,0,0,0,0,0,0,0,0,0,0,0,0,0,0,0,0,0,0,0,0,0,0,0,0,0,0],
      [0,0,0,0,0,0,0,0,0,0,0,0,0,0,0,0,0,0,0,0,0,0,0,0,0,0,0,0],
      [0,0,0,0,0,0,0,0,0,0,0,0,0,0,0,0,0,0,0,0,0,0,0,0,0,0,0,0],
      [0,0,0,0,0,0,0,0,0,0,0,0,0,0,0,0,0,0,0,0,0,0,0,0,0,0,0,0],
      [0,0,0,0,0,0,0,0,0,0,0,0,0,0,0,0,0,0,0,0,0,0,0,0,0,0,0,0],
      [0,0,0,0,0,0,0,0,0,0,0,0,0,0,0,0,0,0,0,0,0,0,52,52,52,52,52,0],
      [0,0,0,0,0,0,0,0,0,0,0,0,0,0,0,0,0,0,0,0,0,0,52,0,0,0,52,0],
      [0,0,0,0,0,0,0,0,0,0,0,0,0,0,0,0,0,0,52,52,52,52,52,0,0,0,52,0],
      [0,0,0,0,0,0,0,0,0,0,0,0,0,0,0,0,0,0,52,0,0,0,52,52,52,52,0,0],
      [0,0,0,0,0,0,0,0,0,0,0,0,0,0,0,0,0,0,52,0,0,0,52,0,0,0,0,0],
      [0,0,0,0,0,0,0,0,0,0,0,52,52,52,52,52,52,52,52,52,0,0,0,0,0,0,0,0],
      [0,0,0,0,0,0,0,0,0,0,0,52,0,0,0,0,0,0,0,52,0,0,0,0,0,0,0,0],
      [0,0,0,0,0,0,0,0,0,0,0,0,0,0,0,0,0,0,0,0,0,0,0,0,0,0,0,0],
      [0,0,0,0,0,0,0,0,0,0,0,0,0,0,0,0,0,0,0,0,0,0,0,0,0,0,0,0],
      [0,0,0,0,0,0,0,0,0,0,0,0,0,0,0,0,0,0,0,0,0,0,0,0,0,0,0,0],
      [0,52,52,52,52,52,52,0,0,0,0,0,0,0,0,0,0,0,0,0,0,52,52,52,52,52,0,0],
      [0,52,0,0,0,0,52,0,0,0,0,0,0,0,0,0,0,0,0,0,0,52,0,0,0,0,52,0],
      [0,52,52,52,52,52,52,0,0,0,0,0,0,0,0,0,0,0,0,0,0,52,52,52,52,52,52,0],
      [0,0,0,0,0,0,0,0,0,0,0,0,0,0,0,0,0,0,0,0,0,0,0,0,0,0,0,0],
      [0,0,0,0,0,0,0,0,0,0,0,0,0,0,0,0,0,0,0,0,0,0,0,0,0,0,0,0],
      [0,0,0,0,0,0,0,0,0,0,0,0,0,0,0,0,0,0,0,0,0,0,0,0,0,0,0,0],
      [0,0,0,0,0,0,0,0,0,0,0,0,0,0,0,0,0,0,0,0,0,0,0,0,0,0,0,0],
      [0,0,0,0,0,0,0,0,0,0,0,0,0,0,0,0,0,0,0,0,0,0,0,0,0,0,0,0],
      [0,0,0,0,0,0,0,0,0,0,0,0,0,0,0,0,0,0,0,0,0,0,0,0,0,0,0,0],
      [0,0,0,0,0,0,0,0,0,0,0,0,0,0,0,0,0,0,0,0,0,0,0,0,0,0,0,0],
      [0,0,0,0,0,0,0,0,0,0,0,0,0,0,0,0,0,0,0,0,0,0,0,0,0,0,0,0],
      [0,0,0,0,0,0,0,0,0,0,0,0,0,0,0,0,0,0,0,0,0,0,0,0,0,0,0,0],
      [0,0,0,0,0,0,0,0,0,0,0,0,0,0,0,0,0,0,0,0,0,0,0,0,0,0,0,0]
    ]
  },
  "npcs": [
    {
      "id": "npc_old_miner",
      "x": 7,
      "y": 14,
      "sprite": "miner",
      "direction": "down",
      "movement": "wander",
      "dialog": [
        "Tach auch! Früher ham wa hier noch richtig malocht, weiße!",
        "Die Zechen sind alle dicht, aber die Monster kommen immer noch ausm Schacht raus.",
        "Dat is ja dat verrückte - die Viecher leben einfach weiter inner Dunkelheit!"
      ]
    },
    {
      "id": "npc_kid",
      "x": 18,
      "y": 18,
      "sprite": "kid",
      "direction": "left",
      "movement": "static",
      "dialog": [
        "Ey, hasse schon gehört? Prof. Budde kann tote Monster wiederbeleben!",
        "Voll krass, ne? Mit so'ner komischen Maschine oder wat.",
        "Mein Kumpel sacht, dat is wie Frankenstein, nur mit Monstern!"
      ]
    },
    {
      "id": "npc_woman",
      "x": 10,
      "y": 8,
      "sprite": "villager_f",
      "direction": "right",
      "movement": "wander",
      "dialog": [
        "Willkommen in Kohlenstadt, Schätzchen!",
        "Wir ham hier alles wat de brauchst - Penny für'n Einkauf, Museum für Kultur...",
        "Und wenn deine Monster ma inner Klemme sind, gehste zum Bergmannsheil!"
      ]
    },
    {
      "id": "npc_guard",
      "x": 3,
      "y": 25,
      "sprite": "guard",
      "direction": "up",
      "movement": "static",
      "dialog": [
        "Pass auf dich auf auf Route 1, Kollege!",
        "Da draußen lauern wilde Monster im hohen Gras.",
        "Ohne eigene Monster bisse aufgeschmissen!"
      ]
    }
  ],
  "warps": [
    { "x": 15, "y": 10, "to": "player_house", "tx": 4, "ty": 6, "direction": "up" },
    { "x": 16, "y": 10, "to": "player_house", "tx": 5, "ty": 6, "direction": "up" },
    
    { "x": 25, "y": 16, "to": "rival_house", "tx": 4, "ty": 6, "direction": "up" },
    
    { "x": 20, "y": 8,  "to": "museum", "tx": 5, "ty": 8, "direction": "up" },
    { "x": 21, "y": 8,  "to": "museum", "tx": 6, "ty": 8, "direction": "up" },
    
    { "x": 24, "y": 6,  "to": "bergmannsheil", "tx": 4, "ty": 6, "direction": "up" },
    
    { "x": 5,  "y": 16, "to": "penny", "tx": 4, "ty": 7, "direction": "up" },
    
    { "x": 3,  "y": 27, "to": "route1", "tx": 9, "ty": 1, "direction": "down" }
  ],
  "triggers": [
    { "x": 14, "y": 10, "event": "sign", "args": { 
      "text": "Dein Zuhause - Muttern wartet bestimmt schon mit'm Essen!" 
    }},
    { "x": 6,  "y": 13, "event": "sign", "args": { 
      "text": "Kohlenstadt - Glück auf!\nHeimat von Prof. Budde's Labor" 
    }},
    { "x": 8,  "y": 16, "event": "sign", "args": { 
      "text": "Penny - Erstma billig, dann wird sich gekümmert!" 
    }},
    { "x": 22, "y": 8,  "event": "sign", "args": { 
      "text": "Museum - Fossilien und Bergbaugeschichte\nEintritt frei für Kumpel!" 
    }},
    { "x": 26, "y": 6,  "event": "sign", "args": { 
      "text": "Bergmannsheil - Wo deine Monster wieder fit werden!\nKeine Kohle? Kein Problem!" 
    }},
    { "x": 6,  "y": 26, "event": "sign", "args": { 
      "text": "←Route 1 - Richtung Dortmund\nAchtung: Wilde Monster!" 
    }}
  ],
  "properties": {
    "music": "town.ogg",
    "encounters": null,
    "spawns": {
      "default": { "x": 14, "y": 14, "direction": "down" },
      "from_player_house": { "x": 15, "y": 11, "direction": "down" },
      "from_rival_house": { "x": 25, "y": 17, "direction": "down" },
      "from_museum": { "x": 20, "y": 9, "direction": "down" },
      "from_bergmannsheil": { "x": 24, "y": 7, "direction": "down" },
      "from_penny": { "x": 5, "y": 17, "direction": "down" },
      "from_route1": { "x": 3, "y": 26, "direction": "up" }
    }
  }
}