{
  "id": "museum",
  "name": "Fossil-Museum",
      "size": {"w": 12, "h": 10, "tile": 64},
  "layers": {
    "ground": [
      [4,4,4,4,4,4,4,4,4,4,4,4],
      [4,4,4,4,4,4,4,4,4,4,4,4],
      [4,4,4,4,4,4,4,4,4,4,4,4],
      [4,4,4,4,4,4,4,4,4,4,4,4],
      [4,4,4,4,4,4,4,4,4,4,4,4],
      [4,4,4,4,4,4,4,4,4,4,4,4],
      [4,4,4,4,4,4,4,4,4,4,4,4],
      [4,4,4,4,4,4,4,4,4,4,4,4],
      [4,4,4,4,4,4,4,4,4,4,4,4],
      [1,1,1,1,1,7,7,1,1,1,1,1]
    ],
    "decor": [
      [5,5,5,5,5,5,5,5,5,5,5,5],
      [5,0,10,10,0,0,0,0,10,10,0,5],
      [5,0,0,0,0,0,0,0,0,0,0,5],
      [5,0,0,0,0,0,0,0,0,0,0,5],
      [5,0,10,0,0,0,0,0,0,10,0,5],
      [5,0,0,0,0,0,0,0,0,0,0,5],
      [5,0,0,0,0,0,0,0,0,0,0,5],
      [5,0,10,10,0,0,0,0,10,10,0,5],
      [5,0,0,0,0,0,0,0,0,0,0,5],
      [5,5,5,5,5,0,0,5,5,5,5,5]
    ],
    "collision": [
      [1,1,1,1,1,1,1,1,1,1,1,1],
      [1,0,1,1,0,0,0,0,1,1,0,1],
      [1,0,0,0,0,0,0,0,0,0,0,1],
      [1,0,0,0,0,0,0,0,0,0,0,1],
      [1,0,1,0,0,0,0,0,0,1,0,1],
      [1,0,0,0,0,0,0,0,0,0,0,1],
      [1,0,0,0,0,0,0,0,0,0,0,1],
      [1,0,1,1,0,0,0,0,1,1,0,1],
      [1,0,0,0,0,0,0,0,0,0,0,1],
      [1,1,1,1,1,0,0,1,1,1,1,1]
    ]
  },
  "warps": [
    {"x": 5, "y": 9, "to": "kohlenstadt", "tx": 20, "ty": 8},
    {"x": 6, "y": 9, "to": "kohlenstadt", "tx": 21, "ty": 8}
  ],
  "triggers": [],
  "properties": {
    "spawns": {
      "entrance": {"x": 5, "y": 8, "direction": "up"},
      "professor": {"x": 5, "y": 2, "direction": "down"}
    }
  }
}