{
  "id": "player_house",
  "name": "Dein Zuhause",
  "size": {"w": 10, "h": 8, "tile": 64},
  "layers": {
    "ground": [
      [9,9,9,9,9,9,9,9,9,9],
      [9,9,9,9,9,9,9,9,9,9],
      [9,9,9,9,9,9,9,9,9,9],
      [9,9,9,9,9,9,9,9,9,9],
      [9,9,9,9,9,9,9,9,9,9],
      [9,9,9,9,9,9,9,9,9,9],
      [9,9,9,9,9,9,9,9,9,9],
      [1,1,1,1,7,7,1,1,1,1]
    ],
    "decor": [
      [5,5,5,5,5,5,5,5,5,5],
      [5,0,10,10,0,0,10,10,0,5],
      [5,0,0,0,0,0,0,0,0,5],
      [5,0,0,0,0,0,0,0,0,5],
      [5,0,0,0,0,0,0,0,0,5],
      [5,0,0,0,0,0,0,0,0,5],
      [5,0,0,0,0,0,0,0,0,5],
      [5,5,5,5,0,0,5,5,5,5]
    ],
    "collision": [
      [1,1,1,1,1,1,1,1,1,1],
      [1,0,0,0,0,0,0,0,0,1],
      [1,0,1,1,0,0,1,1,0,1],
      [1,0,0,0,0,0,0,0,0,1],
      [1,0,0,0,0,0,0,0,0,1],
      [1,0,0,0,0,0,0,0,0,1],
      [1,0,0,0,0,0,0,0,0,1],
      [1,1,1,1,0,0,1,1,1,1]
    ]
  },
  "warps": [
    {"x": 4, "y": 7, "to": "kohlenstadt", "tx": 15, "ty": 10},
    {"x": 5, "y": 7, "to": "kohlenstadt", "tx": 16, "ty": 10}
  ],
  "triggers": [
    {"x": 2, "y": 2, "event": "sign", "args": {"text": "Ein Bett. Zeit aufzustehen!"}},
    {"x": 7, "y": 2, "event": "sign", "args": {"text": "Ein Schreibtisch mit alten Büchern."}}
  ],
  "properties": {
    "spawns": {
      "bed": {"x": 2, "y": 3, "direction": "down"},
      "door": {"x": 4, "y": 6, "direction": "down"}
    }
  }
}