{
  "id": "test_tiles",
  "name": "Test Tiles",
  "size": {
    "w": 16,
    "h": 12,
    "tile": 16
  },
  "layers": {
    "ground": [
      [20,20,20,20,20,20,20,20,20,20,20,20,20,20,20,20],
      [20,20,20,20,20,20,20,20,20,20,20,20,20,20,20,20],
      [20,20,20,20,20,20,20,20,20,20,20,20,20,20,20,20],
      [20,20,20,20,20,20,20,20,20,20,20,20,20,20,20,20],
      [20,20,20,20,20,20,20,20,20,20,20,20,20,20,20,20],
      [20,20,20,20,20,20,20,20,20,20,20,20,20,20,20,20],
      [20,20,20,20,20,20,20,20,20,20,20,20,20,20,20,20],
      [20,20,20,20,20,20,20,20,20,20,20,20,20,20,20,20],
      [20,20,20,20,20,20,20,20,20,20,20,20,20,20,20,20],
      [20,20,20,20,20,20,20,20,20,20,20,20,20,20,20,20],
      [20,20,20,20,20,20,20,20,20,20,20,20,20,20,20,20],
      [20,20,20,20,20,20,20,20,20,20,20,20,20,20,20,20]
    ],
    "decor": [
      [0,0,0,0,0,0,0,0,0,0,0,0,0,0,0,0],
      [0,0,0,0,0,0,0,0,0,0,0,0,0,0,0,0],
      [0,0,0,0,0,0,0,0,0,0,0,0,0,0,0,0],
      [0,0,0,0,0,0,0,0,0,0,0,0,0,0,0,0],
      [0,0,0,0,0,0,0,0,0,0,0,0,0,0,0,0],
      [0,0,0,0,0,0,0,0,0,0,0,0,0,0,0,0],
      [0,0,0,0,0,0,0,0,0,0,0,0,0,0,0,0],
      [0,0,0,0,0,0,0,0,0,0,0,0,0,0,0,0],
      [0,0,0,0,0,0,0,0,0,0,0,0,0,0,0,0],
      [0,0,0,0,0,0,0,0,0,0,0,0,0,0,0,0],
      [0,0,0,0,0,0,0,0,0,0,0,0,0,0,0,0],
      [0,0,0,0,0,0,0,0,0,0,0,0,0,0,0,0]
    ],
    "furniture": [
      [0,0,0,0,0,0,0,0,0,0,0,0,0,0,0,0],
      [0,0,0,0,0,0,0,0,0,0,0,0,0,0,0,0],
      [0,0,0,0,0,0,0,0,0,0,0,0,0,0,0,0],
      [0,0,0,0,0,0,0,0,0,0,0,0,0,0,0,0],
      [0,0,0,0,0,0,0,0,0,0,0,0,0,0,0,0],
      [0,0,0,0,0,0,0,0,0,0,0,0,0,0,0,0],
      [0,0,0,0,0,0,0,0,0,0,0,0,0,0,0,0],
      [0,0,0,0,0,0,0,0,0,0,0,0,0,0,0,0],
      [0,0,0,0,0,0,0,0,0,0,0,0,0,0,0,0],
      [0,0,0,0,0,0,0,0,0,0,0,0,0,0,0,0],
      [0,0,0,0,0,0,0,0,0,0,0,0,0,0,0,0],
      [0,0,0,0,0,0,0,0,0,0,0,0,0,0,0,0]
    ],
    "decoration": [
      [0,0,0,0,0,0,0,0,0,0,0,0,0,0,0,0],
      [0,0,0,0,0,0,0,0,0,0,0,0,0,0,0,0],
      [0,0,0,0,0,0,0,0,0,0,0,0,0,0,0,0],
      [0,0,0,0,0,0,0,0,0,0,0,0,0,0,0,0],
      [0,0,0,0,0,0,0,0,0,0,0,0,0,0,0,0],
      [0,0,0,0,0,0,0,0,0,0,0,0,0,0,0,0],
      [0,0,0,0,0,0,0,0,0,0,0,0,0,0,0,0],
      [0,0,0,0,0,0,0,0,0,0,0,0,0,0,0,0],
      [0,0,0,0,0,0,0,0,0,0,0,0,0,0,0,0],
      [0,0,0,0,0,0,0,0,0,0,0,0,0,0,0,0],
      [0,0,0,0,0,0,0,0,0,0,0,0,0,0,0,0],
      [0,0,0,0,0,0,0,0,0,0,0,0,0,0,0,0]
    ]
  },
  "furniture_placement": [
    {"x": 2, "y": 2, "tile_id": 21, "name": "Computer 1"},
    {"x": 3, "y": 2, "tile_id": 22, "name": "Computer 2"},
    {"x": 2, "y": 3, "tile_id": 23, "name": "Computer 3"},
    {"x": 3, "y": 3, "tile_id": 24, "name": "Computer 4"},
    {"x": 6, "y": 4, "tile_id": 25, "name": "Bücherregal 1"},
    {"x": 7, "y": 4, "tile_id": 26, "name": "Bücherregal 2"},
    {"x": 6, "y": 5, "tile_id": 27, "name": "Bücherregal 3"},
    {"x": 7, "y": 5, "tile_id": 28, "name": "Bücherregal 4"},
    {"x": 10, "y": 6, "tile_id": 29, "name": "Pflanze 1"},
    {"x": 11, "y": 6, "tile_id": 30, "name": "Pflanze 2"},
    {"x": 10, "y": 7, "tile_id": 31, "name": "Pflanze 3"},
    {"x": 11, "y": 7, "tile_id": 32, "name": "Pflanze 4"}
  ],
  "decoration": [
    {"x": 2, "y": 1, "tile_id": 33, "name": "Kunst 1"},
    {"x": 3, "y": 1, "tile_id": 34, "name": "Kunst 2"},
    {"x": 6, "y": 3, "tile_id": 35, "name": "Kunst 3"},
    {"x": 7, "y": 3, "tile_id": 36, "name": "Kunst 4"},
    {"x": 10, "y": 5, "tile_id": 37, "name": "Kunst 5"},
    {"x": 11, "y": 5, "tile_id": 38, "name": "Kunst 6"}
  ],
  "collision": [
    [1,1,1,1,1,1,1,1,1,1,1,1,1,1,1,1],
    [1,1,1,1,1,1,1,1,1,1,1,1,1,1,1,1],
    [1,1,0,0,1,1,1,1,1,1,1,1,1,1,1,1],
    [1,1,0,0,1,1,1,1,1,1,1,1,1,1,1,1],
    [1,1,1,1,1,1,0,0,1,1,1,1,1,1,1,1],
    [1,1,1,1,1,1,0,0,1,1,1,1,1,1,1,1],
    [1,1,1,1,1,1,1,1,1,1,0,0,1,1,1,1],
    [1,1,1,1,1,1,1,1,1,1,0,0,1,1,1,1],
    [1,1,1,1,1,1,1,1,1,1,1,1,1,1,1,1],
    [1,1,1,1,1,1,1,1,1,1,1,1,1,1,1,1],
    [1,1,1,1,1,1,1,1,1,1,1,1,1,1,1,1],
    [1,1,1,1,1,1,1,1,1,1,1,1,1,1,1,1]
  ],
  "warps": [
    {
      "x": 8,
      "y": 10,
      "to": "bergmannsheil",
      "tx": 4,
      "ty": 7,
      "direction": "up"
    }
  ],
  "triggers": [
    {
      "x": 8,
      "y": 8,
      "event": "sign",
      "args": {
        "text": "Test-Karte für neue Tile-Layer!"
      }
    }
  ],
  "npcs": [
    {
      "x": 8,
      "y": 6,
      "sprite": "npc_01",
      "name": "Test-NPC",
      "dialogue": [
        "Ey, das sind ja die neuen Möbel!",
        "Sieht gut aus, wa?"
      ]
    }
  ],
  "properties": {
    "music": "town.ogg",
    "encounters": null,
    "spawns": {
      "default": {"x": 8, "y": 11, "direction": "up"}
    }
  }
}
